let map15 = [
[ 22, 22, 22, 22, 22, 22, 22, 22, 22, 22, 22, 22, 22, 22, 22, 22],
[ 22, 22, 22, 22, 22, 22, 22, 22, 22, 22, 22, 22, 22, 22, 22, 22],
[ 22, 22, 22, 22, 22, 22, 22, 22, 22, 22, 22, 22, 22, 22, 22, 22],
[ 22, 22, 22, 22, 22, 22, 22, 22, 22, 22, 22, 22, 22, 22, 22, 22],
[ 91, 55, 55, 55, 55, 55, 55, 55, 55, 55, 55, 55, 55, 55, 55, 91],
[ 91, 55, 55, 55, 55, 55, 55, 55, 55, 55, 55, 55, 55, 55, 55, 91],
[ 91, 55,  2,  2,  2,  2,  2,  2,  2,  2,  2,  2,  2,  2, 55, 91],
[ 91, 55,  2,  2, 39, 41,  2, 39, 40, 41,  2, 39, 41,  2, 55, 91],
[ 91, 55,  2,  2, 57, 59,  2, 57, 28, 59,  2, 57, 59,  2, 55, 91],
[ 91, 55,  2,  2,  2,  2,  2,  2,  2,  2,  2,  2,  2,  2, 55, 91],
[ 91, 55,  2,  2,  2,  2,  2,  2,  2,  2,  2,  2,  2,  2, 55, 91],
[ 91, 55,  2,  2,  2,  2,  2,  2,  2,  2,  2,  2,  2,  2, 55, 91],
[ 91, 55,  2,  2,  2,  2,  2,  2,  2,  2,  2,  2,  2,  2, 55, 91],
[ 91, 55, 37, 37, 37, 37, 37, 37, 18, 37, 37, 37, 37, 37, 55, 91],
[ 91, 55, 55, 55, 55, 55, 55, 55, 18, 55, 55, 55, 55, 55, 55, 91]];

let map31 = [
[ 22, 22, 22, 22, 22, 22, 22, 22, 22, 22, 22, 22, 22, 22, 22, 22],
[ 22, 22, 22, 22, 22, 22, 22, 22, 22, 22, 22, 22, 22, 22, 22, 22],
[ 22, 22, 22, 22, 22, 22, 22, 22, 22, 22, 22, 22, 22, 22, 22, 22],
[ 22, 22, 22, 22, 22, 22, 22, 22, 22, 22, 22, 22, 22, 22, 22, 22],
[ 55, 55, 55, 55, 55, 55, 55, 55, 55, 55, 55, 55, 55, 55, 55, 91],
[ 55, 55, 55, 55, 55, 55, 55, 55, 55, 55, 55, 55, 55, 55, 55, 91],
[  2,  2,  2,  2,  2,  2,  2,  2,  2,  2,  2,  2,  2,  2, 55, 91],
[  2,  2,  9, 11,  2,  9, 10, 11,  2,  2,  9, 11,  2,  2, 55, 91],
[  2,  2, 27, 29,  2, 27, 28, 29,  2,  2, 27, 29,  2,  2, 55, 91],
[  2,  2,  2,  2,  2,  2,  2,  2,  2,  2,  2,  2,  2,  2, 55, 91],
[  2,  2,  2,  2,  9, 11,  2,  2,  9, 11,  2,  9, 11,  2, 55, 91],
[  2,  2,  2,  2, 27, 29,  2,  2, 27, 29,  2, 27, 29,  2, 55, 91],
[  2,  2,  2,  2,  2,  2,  2,  2,  2,  2,  2,  2,  2,  2, 55, 91],
[ 37, 37, 37, 37, 37, 37, 37, 37, 37, 37, 37, 37, 37, 37, 55, 91],
[ 55, 55, 55, 55, 55, 55, 55, 55, 55, 55, 55, 55, 55, 55, 55, 91]];